10.ox
..........
..........
..........
..o.......
..........
..........
.....oo...
..o..o....
..........
.oo.......
